Bairro de Fátima	=> Centro
Castelo	=> Centro
Ladeira de São Carlos	=> Estácio
Parque Arará	=> Benfica
Providência	=> Gamboa e Santo Cristo
Triagem	=> Benfica
Aldeia Campista =>	Andaraí, Tijuca e Vila Isabel
Pedreira =>	Anchieta e Costa Barros
Bananal	=> Freguesia (Ilha do Governador)
Boca do Mato	=> Engenho de Dentro e Lins de Vasconcelos
Buraco do Padre	=> Engenho Novo
Chave de Ouro	=> Méier e Engenho de Dentro
Consolação	=> Engenho Novo e Grajaú
Dadur	=> Água Santa
Fazenda Botafogo	=> Acari e Coelho Neto
Fazenda da Bica =>	Cascadura e Quintino Bocaiuva
Mariópolis	=> Anchieta
Muda	=> Tijuca
Praça do Carmo =>	Penha e Vila da Penha
Tubiacanga =>	Galeão
Usina	=> Alto da Boa Vista e Tijuca
Vila Cruzeiro	=> Penha
Village	=> Jardim Carioca
Arpoador	=> Copacabana e Ipanema
Peixoto =>	Copacabana
Fonte da Saudade =>	Lagoa
Horto	=> Jardim Botânico
Largo do Machado	=> Catete e Laranjeiras
Silvestre	=> Alto da Boa Vista, Cosme Velho e Santa Teresa
Tavares Bastos	=> Catete
Barrinha =>	Barra da Tijuca
Bairro Araújo =>	Senador Camará
Catiri	=> Bangu
Colônia	=> Taquara
Conjunto Cesário de Melo	=> Santa Cruz
Guilherme da Silveira	=> Bangu
Jabour	=> Bangu e Senador Camará
Jardim Adriana	=> Campo Grande
Jardim Boiuna	=> Taquara
Jardim Oceânico	=> Barra da Tijuca
Manguariba	=> Paciência
Mallet	=> Realengo
Mato Alto	=> Praça Seca e Tanque
Novo Horizonte	=> Campo Grande
Recanto das Palmeiras =>	Curicica e Taquara
Rio das Pedras	=> Anil e Itanhangá
Rolas	=> Santa Cruz
Terreirão do Rio Bonito	=> Recreio dos Bandeirantes
Vila Aliança	=> Bangu
Vila Kennedy	=> Bangu e Gericinó
Vila Oiticica	=> Campo Grande
Vila Rudicéa	=> Campo Grande
Jardim Palmares	=> Paciência
